abstract : UDBSUTCB
arguments : TUOFNVHSB
boolean : OBFMPPC
break : LBFSC
byte : FUZC
case : FTBD
catch : IDUBD
char : SBID
const : UTOPD
continue : FVOJUOPD
debugger : SFHHVCFE
default : UMVBGFE
delete : FUFMFE
do : PE
double : FMCVPE
else : FTMF
eval : MBWF
false : FTMBG
final : MBOJG
finally : ZMMBOJG
float : UBPMG
for : SPG
function : OPJUDOVG
goto : PUPH
if : GJ
implements : TUOFNFMQNJ
in : OJ
instanceof : GPFDOBUTOJ
int : UOJ
interface : FDBGSFUOJ
let : UFM
long : HOPM
native : FWJUBO
new : XFO
null : MMVO
package : FHBLDBQ
private : FUBWJSQ
protected : EFUDFUPSQ
public : DJMCVQ
return : OSVUFS
short : USPIT
static : DJUBUT
switch : IDUJXT
synchronized : EFAJOPSIDOZT
this : TJIU
throw : XPSIU
throws : TXPSIU
transient : UOFJTOBSU
true : FVSU
try : ZSU
typeof : GPFQZU
var : SBW
void : EJPW
volatile : FMJUBMPW
while : FMJIX
with : IUJX
yield : EMFJZ